1. Wat is de natuurkundige eenheid van druk? 	Bar
2. Welke boor is naar een insect vernoemd? 	Vlinderboor
3. Welke materiaal is magnesium? 	Metaal
4. Waar staat de afkorting HSS voor op een boortje? 	High Speed Steel
5. Hoeveel is de wortel van 25 in het kwadraat? 	25
6. Hoe noem je het gedeelde van een slot waar je de sleutel insteekt? 	Cilinder
7. Welke steen kan door het lichaam worden gevormd? 	Niersteen
Over hoeveel USB-aansluitingen beschikt de Playstation 3 Slim? 	2
9. Waar staat de afkorting EQ voor? 	Emotioneel quotiënt
10. Wat krijg je als je cement en grind met elkaar mengt? 	Beton
11. Wie vond als eerst de telefoon uit? 	Antionio Meucci
12. Hoeveel tanden en kiezen heeft een volwassen persoon? 	32
13. Welk metaal is als enige bij kamertemperatuur vloeibaar? 	Kwik
14. Hoe wordt een tweede keer volle maan in één maand genoemd? 	Een blauwe maan
15. Welke kleur is de middelste kleur van een regenboog? 	Groen
16. Hoeveel kilometer is de omtrek van de aarde? 	40.000 km
17. Wat zijn de eerste 3 priemgetallen? 	2,3 en 5
18. De vijf planeten die het dichtst bij ons zijn? 	Mercurius, Venus, Mars, Jupiter en Saturnus
19. Hoeveel cc heeft de motorinhoud van een 2 liter motor? 	Ongeveer 2000cc
20. Welke lichtstraal heeft een tv afstandsbediening? 	Infra Rood
21. Waar staat de afkorting SMS voor? 	Short Message Service
22. Hoeveel kilobyte is 1 megabyte? 	1024
23. Wat is de gemiddelde snelheid van een groot passagiers vliegtuig? 	1000km p/u
24. Met welke snelheid knip je je vingers? 	Ongeveer 45km p/u
25. Wat is kleiner dan een molecuul? 	Atoom



	
26. Wat betekent de afkorting IR? 	Infra rood
27. Op hoeveel volt werkt een USB aansluiting? 	5 Volt
28. Hoe heette vroeger de koelende vloeistof in een vriezer? 	Freon
29. Hoe heet het metaal dat in de scheikunde aangeduid wordt met Al? 	Aluminium
30. Wat is de snelheid van geluid? 	340m per seconde
31. Met welk gas wordt een ballon opgeblazen die kan zweven? 	Helium
32. Wie was de uitvinder van elektriciteit? 	Thomas Edison
33. Wat is de codenaam van Android 4.1? 	Jelly Bean
34. Welke smartphone was de eerste telefoon met een Dualcore-processor? 	De LG Optimus 2x Speed
35. Waarvoor staat de afkorting NFC? 	Near Field Communication
36. Waarvoor staat de I in de afkorting HDMI? 	Interface
37. Naar welk werelddeel is een van de manen van Jupiter vernoemd? 	Europa
38. In welk jaar is electronicabedrijf Apple (o.a. bekend van de Iphone) opgericht? 	1976
39. Welke codenaam heeft Android 2.3? 	Gingerbread
40. Welke spelcomputer stond eerder bekend onder de naam Nintendo Revolution? 	De Nintendo Wii
41. In welk jaar werd de allereerste sms verstuurd? 	1992
42. In welk jaar kwam de eerste Blackberry op de markt? 	1999
43. Hoe wordt een periode van 1 miljard jaar genoemd? 	Een Giga-annum