1. Wat is het tegenoverstelde van conservatief? 	Progressief
2. In welk lichaamsdeel vind je het aambeeld? 	In het oor
3. Welke Amerikaanse krant heeft als bijnaam The Old Gray Lady? 	The New York Times
4. Hoe noem je een trap die spiraalvormig omhoog gaat? 	Een wenteltrap
5. Wat maakt pestosaus groen? 	basilicum
6. Wie schreef het boek “alleen op de wereld”? 	Hector Malot
7. Hoe heet de woning van de paus? 	Vaticaan
8. Hoeveel zintuigen heeft een mens? 	5
9. Voor hoeveel procent bestaat een menselijk lichaam uit water? 	70%
10. Hoe heet het duizendste deel van een kilogram? 	Een gram
11. Van welke godsdienst is de Koran het heilige boek? 	Islam
12. Hoe noem je benen met naar buiten wijzende knieën? 	O-benen
13. Wat is de gewichtseenheid van diamanten? 	Karaat
14. Welke kleur heeft de jas van een chirurg meestal? 	Groen
15. Uit hoeveel tekens kan één sms-bericht maximaal bestaan? 	160
16. Wat is een ander woord voor Toendra? 	Mossteppe
17. Hoeveel dagen doet de aarde erover om 1 keer om de zon te draaien? 	365
18. Waarmee wordt normaal gesproken geschreven op een whiteboard? 	Viltstiften
19. Wat is een ander woord voor alpinist? 	Bergbeklimmer
20. Hoe noem je een jaar met 366 dagen? 	Een schrikkeljaar
21. Wat is het Italiaanse woord voor meester of leraar? 	Maestro
22. Wie schreef het sprookje “de kleine zeemeermin”? 	Hans Christiaan Andersen
23. Wat zijn de eerste 6 letters van een Frans en Belgisch toetsenbord? 	Azerty
24. In welk jaar is electronicabedrijf Apple (o.a. bekend van de Iphone) opgericht? 	1976
25. Hoe wordt de mand onder een hete luchtballon genoemd? 	Gondel




	
26. Wie bedacht Suske en Wiske? 	Willy Vandersteen
27. Hoe heet het Heilige boek van de joden? 	Thora
28. Hoe wordt het genre dat uit gedichten bestaat genoemd? 	Poëzie
29. 49. Door welk kanaal zijn Afrika en Azië van elkaar gescheiden? 	Suezkanaal
30. Hoe noem je iemand die met roofvogels werkt? 	Een valkenier
31. Hoe noem je de persoon die een testament voor iemand opmaakt? 	Notaris
32. Wat is de Engelse benaming voor producten die niet eetbaar zijn? 	Non-food
33. Welk beroep oefent een zielenknijper uit? 	Psychiater
34. Wat is een ander woord voor pedometer? 	Stappenteller
35. Welk sterrenbeeld zit tussen Ram en Tweelingen in? 	Stier
36. Wat is meestal de hoogste en de laagste kaart in een kaartspel? 	De aas
37. Wat is het volume van een kilo water? 	Een liter
38. Wat is een ander woord voor goochelaar? 	Illusionist
39. Wat is een ander woord voor blauwe plek? 	Hematoom
40. Hoe heet het vriendinnetje van Superman? 	Loïs Lane
41. Hoe wordt rondslingerend afval genoemd? 	Zwerfvuil
42. Naar welke Romeinse god is zaterdag vernoemd? 	Saturnus
43. Welke kleur heeft zuurstofarm bloed? 	Blauw
44. Met welke letter worden zachte potloden aangeduid? 	B
45. Wat is het tegenovergestelde van analoog? 	Digitaal
46. Hoe noem je scouts van 7 tot 11 jaar? 	Welpen
47. Hoe noemt men het zachtjes golven van water? 	Kabbelen
48. Hoeveel weken is een vrouw zwanger? 	38
49. Wat is en zeeduivel? 	Een vis
50. Wat is een ander woord voor stofwisseling? 	Metabolisme
51. Van welk woord is het woord “gel” afgeleid? 	Gelatine
52. Het franse woord voor halsketting is? 	Collier
53. Hoe word een luchtspiegeling ook wel genoemd? 	Fata Morgana
54. Waardoor worden jeugdpuistjes voornamelijk veroorzaakt? 	Hormonen
55. Welke planeet is de grootste in ons zonnestelsel? 	Jupiter
56. In welk jaar werd de euro ingevoerd? 	2002
57. Wat wordt bedoeld met het woord absentie? 	Afwezigheid
58. Wat komt in China na iemands achternaam? 	De voornaam
59. Wat bedoeld men met broodheer? 	De werkgever
60. Welk bedrijf is uitgever van Hello Kitty? 	Sanrio
61. Wat is de figuurlijke kleur van een huismerk? 	Wit
62. Hoe wordt een flat met meer dan 12 verdiepingen ook wel genoemd? 	Wolkenkrabber
63. Hoe heet de schrijfster van Pipi Langous 	Astrid Lindgren
64. Welke feestdag wordt 40 dagen na Pasen gevierd? 	Hemelvaartsdag
65. Wat zijn Courier, Comic Sans en Arial? 	Lettertypes
66. In welk lichaamsdeel zit de meniscus? 	Knie
67. Van welke stof in het zwembadwater kun je rode ogen krijgen? 	Chloor
68. Hoe wordt een vakantiehuis in Frankrijk vaak genoemd? 	Een gîte
69. Wat is de gemiddelde brandtijd van een waxinelichtje? 	4 uur
70. Wat is de meest gespeelde vorm van het kaartspel poker? 	Texas Hold ’em
71. Welk speelstuk kan bij stratego als enige de bom uitschakelen? 	een mineur
72. Welke kleur zie je spreekwoordelijk wanneer je jaloers bent? 	Groen
73. Uit hoeveel velden bestaat een schaakbord? 	64
74. Welke kaart kun je naast een kanskaart nog meer moeten pakken bij het bordspel Monopoly? 	Algemeen Fonds
75. Welke puzzel werd in 1979 voor het eerst gepubliceerd onder de naam Number Place? 	Sudoku
76. Met hoeveel speelkaarten wordt bridge gespeeld? 	52
77. Hoe wordt een licht strafbaar feit genoemd? 	een overtreding
78. Welke maand wordt ook wel sprokkelmaand genoemd? 	Februari
79. Hoe wordt een tijdelijke stoornis van de hersenen genoemd? 	Een black-out
80. Wat is de bekendste en meest voorkomende alcohol? 	Ehtanol
81. Waarvoor is iemand van coulrofobie bang? 	Clowns
82. Hoe worden chemische bestrijdigsmiddelen vaak genoemd? 	pesticiden
83. De verzamelnaam voor middelen ter verhoging van lichamelijke schoonheid of hygiëne is? 	Cosmetica
84. Hoe wordt het versieren van nagels vaak genoemd? 	Nail art
85. Hoe wordt de verstoring van het slaap-waakritme genoemd? 	Jetlag
86. In welke stad in België word driejaarlijks de kattenstoet gehouden? 	Ieper
87. Hoe heet de mascotte van Landal Greenparks? 	Bollo de Beer