1. In welke maateenheid wordt een beeldscherm aangeduid? 	Inch
2. Welke toetsenbord indeling gebruiken we in Nederland? 	Qwerty
3. Hoe noemt men een kunststof colafles? 	Petfles
4. Wat is een andere benaming voor sifon? 	Zwanenhals
5. Hoeveel potloodbatterijen maken samen 4,5 volt? 	3
6. Wat is de tegenhanger van gelijkspanning? 	Wisselspanning
7. Hoe noem je de lamp die als koplamp in de auto wordt gebruikt? 	Halogeen
8. Wat geeft een gloeilamp het meest af? 	Warmte
9. In welke stad staat de Technische Universiteit (TU)? 	Delft
10. Hoe luidt de stelling van Pythagoras? 	a2+b2=c2
11. Welke plaats heeft de maand in de Amerikaanse tijdnotatie? 	Voorop, mm-dd-jj
12. Welk metaalsoort is een van de lichtste? 	Aluminium
13. Met welke tol kun je dingen doormidden zagen? 	Slijptol
14. Welke kleur bloedlichaampjes kennen we? 	Rood en wit
15. Vergeleken met de aarde is op de maan de zwaartekracht? 	Lager
16. Waar staat de afkorting IQ voor? 	Intelligentie quotiënt
17. Wat is de hardste steen op aarde? 	Diamant
18. In welk jaar was de eerste maanlanding? 	1969
19. Waar staat de afkorting Hz voor? 	Hertz
20. Wat duiden Kelvin en Fahrenheit aan? 	Temperatuur
21. Wat was de naam van de man die als eerste een voet op de maan zette? 	Neil Armstrong
22. Waar staat het getal 3,14 voor? 	Pi
23. Hoe wordt een 5 puntige ster ook wel genoemd? 	Pentagram
24. Hoeveel bougies of gloeipluggen heeft een 6-cilinder? 	6
25. Welke letter staat voor 1000? 	K



	
26. Hoe wordt het mobile telefoon netwerk genoemd? 	GSM
27. Welk telefoonmerk had als populaire model 5100 en 5230? 	Nokia
28. Op welke brandstof reed de eerste trein? 	Stoom
29. Hoe wordt een meteoor die de aarde bereikt genoemd? 	Meteoriet
30. Wat is de eigenschap van metaal als het warm wordt? 	Het zet uit
31. Waarmee kun je een uitvinding beschermen? 	Octrooi of patent
32. Wat zijn de 3 primaire kleuren van een beeldpixel? 	Rood, groen en blauw
33. Hoe noem je de printvulling van een laserprint? 	Toner
34. Hoe noem je bougies voor een diesel auto? 	Gloeipluggen
35. Waar staat de afkorting RVS voor? 	Roest vast staal
36. Voor welke stof staat de afkorting h2o? 	Water
37. Op welke schaal worden aardbevingen weergegeven? 	Richter
38. Wie is de bedenker van het internet? 	Bill Gates
39. Hoe heet het besturingssysteem van de Iphone? 	iOS
40. Hoe heet de camera voor de Xbox die het mogelijk maakt je lichaam als controller te gebruiken? 	Kinect
41. Welk bedrijf ontwikkelde de Blackberry? 	Research in Motion
42. Wat is de naam van de extra grote variant van de Nintendo 3DS? 	De Nintendo 3DS XL
43. Uit welk land komt Nokia? 	Finland
44. Aan hoeveel pixels is 1 megapixel gelijk? 	1 miljoen