1. Wanneer eindigde de eerste wereldoorlog? 	1918
2. Hoe noem je het overblijfsel van een religieus voorwerp? 	Een relikwie
3. Hoe heette de vader van Anne Frank? 	Otto
4. Welk land stuurde de eerste mens de ruimte in? 	Sovjet-Unie
5. Wanneer begon de tweede wereldoorlog? 	1939
6. Hoe heette de zus van Anne Frank? 	Margot
7. In welk jaar overleed prins Bernhard? 	2004
8. Naar welk land vluchtte koningin Wilhelmina tijdens de tweede wereldoorlog? 	Engeland
9. Wat was het beroep van Frans Hals? 	Schilder
10. Welke dictator werd op 30 december 2006 in Bagdad geëxecuteerd? 	Saddam Hoessein
11. Uit welk land kwam de schrijver en filosoof Plato? 	Griekenland
12. Hoe worden Romeinen genoemd die in amfitheaters vochten als leedvermaak? 	Gladiatoren
13. Welk werelddeel werd ooit Nieuw-Holland genoemd? 	Australië
14. Waarvoor staat de afkorting VOC? 	Verenigde Oostindische Compagnie
15. Waarvan is het leger gemaakt dat staat bij het graf van Keizer Qin Shi Huangdi? 	Klei
16. Welk object liet keizer Qin Shi Huangdi bouwen om het Chinese keizerrijk te beschermen? 	De Chinese Muur
17. Onder welke naam is het Fravisch Amfitheater beter bekent? 	Het colosseum
18. Hoe werden de volgelingen van Calvijn en Luther, die hun eigen kerken vormden genoemd? 	De protestanten
19. Bij welke kunstenaar ging Gerrit (ook wel Gerard genoemd) Dou in de leer? 	Rembrandt
20. In welke bunker pleegde Adolf Hitler op 30 april 1945 zelfmoord? 	Führerbunker
21. In welke Griekse stad werden vroeger door de Grieken de Olympische spelen gehouden? 	Olympia
22. Waar dacht Christoffel Columbus dat hij was toen hij in 1492 Amerika ontdekte? 	India
23. Welk land werd vroeger “Het land van het Midden” genoemd omdat de bewoners dachten dat het het middelpunt op aarde was? 	China
24. Wie was de eerste vrouwelijke huisarts? 	Aletta Jacobs