1. Welke Italiaanse voetbalclub wordt vergeleken met een oude dame? 	Juventus
2. In welke stad brandde het Olympische vuur voor het eerst? 	Amsterdam
3. Van welk atletiek onderdeel heeft Mike Powell sinds 1991 het record op zijn
naam staan?” 	Verspringen
4. Uit welk onderdeel bestaat een originele triatlon naast zwemmen en fietsen
nog meer?” 	Hardlopen
5. Welke Nederlandse gemeente heeft als enige geen voetbalvereniging? 	Vlieland
6. In welk jaar werd het Feyenoord stadion geopend? 	1937
7. Hoe wordt het scorebord bij kaatsen genoemd? 	Telegraaf
8. Sinds welk jaar is ijshockey een Olympische sport? 	1920
9. Hoeveel kilo weegt een discus voor vrouwen bij het discuswerpen? 	1 Kilo
10. Hoe worden bij het bowlen 3 strikes achter elkaar genoemd? 	Turkey
11. Bij welke sport hoort het lied “Take me out to the Ball Game”? 	Honkbal
12. Welke sport is onder te verdelen in de categorieën cross country, downhill, dirt jumping, enduro en freeride? 	Mountainbiken
13. Welke sport betekend in het Japans “zachte weg”? 	Judo
14. Om de hoeveel jaar wordt het wereldkampioenschap cricket gehouden? 	Om de 4 jaar
15. Welke sport wordt beoefend bij biatlon? 	Skisport
16. Bij welke sport kan men de titel Mr. Olympia behalen? 	Bodybuilding
17. Hoe worden de aangepaste skistokken genoemd die worden gebruikt bij nordic walking? 	Poles
18. Bij welke sport heb je te maken met een loodgordel, een buddylijn en een manometer? 	Duiksport
19. Hoe heet de uitgezette route voor langlaufers? 	Een loipe
20. Welke sport is ontstaan toen een groep duikers op zoek was naar een manier om in de winter hun conditie op peil te houden? 	Onderwaterhockey
21. Hoe wordt het bij snowboarden genoemd wanneer je met je rechtervoet voorop het board staat? 	Goofy
22. Welke extreme vorm van surfen begint pas bij golven van 8 meter hoog? 	Big Wave Surfing
23. Van welke 2 sporten is duatlon een combinatie? 	Wielrennen en hardlopen