1. Hoeveel snaren heeft een gitaar gewoonlijk? 	6
2. Met welk nummer brak zangeres Shakira in 2001 wereldwijd door? 	Whenever Wherever
3. In welk jaar overleed de zanger Michael Jackson? 	2009
4. Met welke boyband is Justin Timberlake doorgebroken? 	Nsync
5. Bij welke popgroep zong Robbie Williams van 1990 – 1995? 	Take That
6. In welke R&B-groep zong Beyonce Knowles voordat zij solo zong? 	Destiny’s Child
7. Wat is een ander wordt voor toondichter? 	Een componist
8. Wat is de bijnaam van zangeres Beyonce? 	Bee
9. In welke taal zong Marco Borsato voordat hij doorbrak met Nederlandstalige nummers? 	Italiaans
10. Hoe heette het eerste nummer van Britney Spears 	Baby one more time
11. Welke actrice werd in 2011 de vriendin van zanger Justin Bieber? 	Selena Gomez
12. In welk jaar overleed Whitney Houston? 	2012
13. Hoeveel zwarte toetsen heeft een standaard piano? 	36
14. Hoe heet het jongste zusje van Michael Jackson? 	Janet Jackson
15. Hoe gaat het liedje verder: Oh, Oh Den Haag, mooie stad……? 	Achter de duinen
16. Welke zangeres had als eerste hit Genie in a bottle? 	Christina Aguilera
17. Van wie waren de hits Firestarter en Smack my Bitch up? 	The Prodigy
18. Wie won in 2003 het eerste seizoen van Idols? 	Jamai
19. Welke groep had een hit met het nummer Barbie Girl? 	Aqua
20. Met welk nummer werd Lady Gaga in 2008 werelwijd bekend? 	Just Dance
21. Welke zangeres is de dochter van Keith Allen? 	Lily Allen
22. Welke zangeres heeft onder andere de bijnamen Queen of pop, Mo en Madge? 	Madonna
23. Hoe wordt de bespeler van een orgel genoemd? 	Een organist
24. Hoe wordt een vrouwelijk DJ ook wel genoemd? 	Een Djane
25. In welke groep zongen Wyclef Jean, Lauryn Hill en Pras? 	De Fugees




26. Waarvan is de artiestennaam LL Cool J de afkorting? 	Ladies love cool James
27. Wie had een hit met het nummer Relax, take it easy? 	Mika
28. Welk instrument betekend in het Hawaïaans “springende vlo”? 	Ukelele
29. Van welke boyband maakte Nick Lachey deel uit? 	98 Degrees
30. Hoe wordt het muziekgedeelte genoemd waarbij vaak een stuk muziek wordt herhaald? 	refrein
31. Welke zangeres had onder andere hits met Dr. Beat, Bad boy en Rhythm is gonna get you? 	Gloria Estefan
32. Waarvan is CD de afkorting? 	Compact disc
33. Over welk lid van The Beatles gingen geruchten rond dat hij was overleden en dat een look-a-like zijn plaats innam? 	Paul McCartney
34. Wie was de zanger in de band Volumia!? 	Xander de Buisonjé
35. Wie zong het nummer Tears in Heaven nadat zijn zoontje was overleden? 	Eric Clapton
36. Welke Britse band vormen Chris Martin, Jon Buckland, Will Champion en Guy Berryman? 	Coldplay
37. Met welke artiest bracht zangeres Beyonce het nummer Baby Boy uit? 	Sean Paul
38. Welke zangeres kan zichzelf naast Madonna ook Queen op pop noemen? 	Britney Spears