1. Hoe lang duurt een professionele voetbalwedstrijd? 	90 minuten
2. Hoe wordt een corner met een Nederlands woord ook wel genoemd? 	Hoekschop
3. Hoe noem je een vrouwelijke balletdanser? 	Ballerina
4. Bij welke sport horen de termen “strike” en “spare”? 	Bowlen
5. Hoe wordt de balsport genoemd waarbij men eigenlijk tikkertje speelt met de bal? 	Trefbal
6. Hoe wordt een doelverdediger bij voetbal genoemd? 	Een keeper
7. Hoe wordt een beoefenaar van judo genoemd? 	Een judoka
8. Welke kleur heeft de uitrusting van een schermer meestal? 	Wit
9. Bij welke sport horen de woorden cap en amazone? 	Paardensport
10. Hoe heet de Haagse voetbalclub? 	ADO Den Haag
11. Om de hoeveel jaar worden de Olympische zomerspelen gehouden? 	4
12. Hoe wordt een groep wielrenners ook wel genoemd? 	Een peloton
13. Hoe wordt bij basketbal het stuiteren van de bal genoemd om te kunnen lopen met de bal? 	Dribbelen
14. Hoe wordt een beoefenaar van de vechtkunst karate genoemd? 	Karateka
15. Wat wordt bij voetbal bedoeld met het Engelse “offside”? 	Buitenspel
16. Waarmee wordt een hole bij golf gemerkt? 	Vlaggenstok
17. Hoe heet het gedeelte van een berg dat geprepareerd is om te skiën? 	Piste
18. Welke sport wordt beoefend op de TT Assen 	Motorrace
19. Hoe wordt de watervariant van handbal genoemd? 	Waterpolo
20. Bij welke sport danst met op spitzen? 	Ballet
21. Hoe worden de stokken waarmee geslagen wordt bij golf genoemd? 	(golf)clubs
22. Welke sport staat centraal in de film Black Swan? 	Ballet