1.       Wat voor hond is Rex in de tv-serie “commissaris Rex”? 	Een herdershond
2.       Welke vogel staat bekend om zijn grote veelkleurige snavel? 	De toekan
3.       Hoeveel weken is een poes gemiddeld zwanger? 	9
4.       Waarmee proeven vlinders? 	Met hun poten
5.       Wat is het grootste zoogdier op aarde? 	De blauwe vinvis
6.       Welke vogel is de meest voorkomende ter wereld? 	De kip
7.       In welk land is de koe een heilig dier? 	In India
8.       Wat is een andere naam voor de prairiewolf? 	Coyote
9.       Hoe wordt het eitje van een hoofdluis genoemd? 	Een neet
10.   Welke hond heeft een blauwe tong? 	Chowchow
11.   Hoeveel tenen heeft een papegaai aan één poot? 	4
12.   Wat is het kleinste ponyras? 	Shetlandpony
13.   Hoeveel vleugels heeft een mug? 	2
14.   Welk dier wordt ook wel buidelbeer genoemd? 	De koala
15.   Welke soort reiger komt in Nederland en België het meest voor? 	De blauwe reiger
16.   Wat wordt meestal gemaakt van de huid van krokodillen? 	(krokodillen)leer
17.   Welk dier wordt in het Engels “raccoon” genoemd? 	De wasbeer
18.   Waarin leggen mestkevers hun eieren? 	In mest
19.   Wat voor soort vogel is de Amerikaanse oehoe? 	Een uil
20.   Van welk geslacht is een lapjeskat meestal? 	Vrouwelijk geslacht
21.   Hoelang is de nek van een volwassen giraf gemiddeld? 	3 meter
22.   Wat was in 2011 de meest populaire hondennaam? 	Luna
23.   In welk land wordt kogelvis als lekkernij gegeten? 	Japan
24.   Welk dier staat op het pakje sigaretten van het merk “camel”? 	Dromedaris
25.   Hoeveel poten heeft een kreeft? 	10




26.   Welke kleur hebben kaketoes meestal? 	Wit
27.   Hoe worden slakken zonder schelp genoemd? 	naaktslakken
28.   Hoelang duurt de draagtijd bij een ezel? 	12 maanden
29.   Wat voor soort vis is Nemo in de film ”Finding Nemo”? 	Clownvis / anemoonvis
30.   Heeft een zebra op zijn poten horizontale of verticale strepen? 	Horizontaal
31.   Welke kleur is overheersend bij de Jackrussell terriër? 	Wit
32.   Van welk dier wordt het bloed gebruikt in kleurstoffen? 	Luis
33.   Wanneer valt dierendag? 	Op 4 oktober
34.   Hoeveel liter melk geeft een koe gemiddeld per dag? 	24
35.   Van welke boom eten koala’s meestal de bladeren? 	De eucalyptusboom
36.   Welk dolfijnsoort is het grootst? 	De orka
37.   Welk weekdier leeft als enige ook op het land? 	De slak
38.   In welk werelddeel leven pauwen in het wild? 	In Azië
39.   Hoe worden jonge zeehonden die hun moeder kwijt zijn genoemd? 	Huilers
40.   Hoeveel pootjes heeft een garnaal? 	10
41.   Hoe heet de orka die in 2010 opgevangen werd in het Dolfinarium? 	Morgan
42.   Welke katachtige is het snelste zoogdier ter wereld? 	Het jachtluipaard
43.   Van welk hondenras is Samson uit de tv-programma Samson en Gert? 	Een bobtail
44.   Hoe noemen we dieren die zowel vlees als planten eten? 	Omnivoren
45.   Welke hondenras wordt vaak gebruikt bij het opsporen van mensen? 	De bloedhond
46.   Wat is de grootste nog levende roofvis ter wereld? 	De witte haai (mensenhaai)
47.   Waaraan wordt de leeftijd van ijsberen bepaald? 	Aan de tanden
48.   Hoe wordt het haarbraaksel van katten genoemd? 	Haarbal
49.   Welk dier staat symbool tegen zinloos geweld? 	Het lieveheersbeestje
50.   Welke vis staat bekend als snelste vis ter wereld? 	De zeilvis
51.   Hoe wordt een kruising tussen een labrador en een poedel genoemd? 	Een labradoodle
52.   Wat is een andere naam voor een schaapkameel? 	Een lama
53.   Welk dier is mascotte voor het pretpark Walibi Holland? 	De wallaby (kangoeroe)
54.   Hoeveel hoorns heeft de witte neushoorn op zijn neus? 	2
55.   Welk dieren wordt gebruikt bij het balspel polo? 	Paarden
56.   Welke kleur hebben de poten van eenden? 	Oranje
57.   Wat was in 2011 de meest populaire kattennaam? 	Tijger
58.   Hoeveel procent van de kwal bestaat uit water? 	95 procent
59.   Hoe wordt een paling ook wel genoemd? 	Een aal
60.   Waar leggen duizendpoten hun eieren? 	In de grond
61.   Welke parasiet staat bekend als overbrenger van de ziekte van lyme? 	De teek
62.   Wat voor aap is Bokito, die in 2007 uit zijn verblijf ontsnapte? 	Een (zilverrug)gorilla
63.   Hoeveel halswervels heeft een giraf? 	7
64.   Hoe worden dieren genoemd die alleen maar planten eten? 	Herbivoren
65.   Hoe worden vrouwelijke walrussen genoemd? 	Koeien
66.   Hoe worden vogels genoemd die in bepaalde seizoenen naar andere landen trekken? 	Trekvogels
67.   Welke vogel kan als enige achteruitvliegen? 	De kolibrie
68.   Wat is een tuimelaar? 	Een dolfijn
69.   Bij welk soort hert draagt ook het vrouwtje een gewei? 	Het rendier
70.   Hoe wordt een mannetjesduif genoemd? 	Een doffer
71.   Hoe heet de ziekte die bij vissen die witte stippen veroorzaak? 	Witte stip
72.   Hoe wordt iemand die duiven houdt genoemd? 	Een duivenmelker
73.   Hoe wordt een mannetjes eend genoemd? 	Woerd
74.   Welk soort slang is het langst? 	De python
75.   Bij welk dier wordt het mannetje zwanger? 	Het zeepaardje
76.   Van welke vis is kaviaar afkomstig? 	De steur
77.   Hoe wordt het omhulsel genoemd dat rupsen maken? 	Cocon
78.   Welke dieren worden gehouden in een formicarium? 	Mieren
79.   Waar komt de kanarie oorspronkelijk vandaan? 	De Canarische Eilanden
80.   Wat is een wallaby? 	Een kleine kangoeroe
81.   Door de steek van welk dier kwam Steve Irwin (the Crocodile Hunter) om het leven 	De pijlstaartrog
82.   Hoeveel poten heeft een krab? 	10
83.   Welk dier wordt ook wel “gevleugelde rat” genoemd? 	De duif
84.   Hoe wordt een groep mieren genoemd? 	Een kolonie
85.   Wat is de grootste roggensoort ter wereld? 	De reuzenmanta
86.   Wat is de meest voorkomende infectieziekte bij katten? 	De niesziekte
87.   Hoe wordt de rangorde bij kippen en hanen genoemd? 	Pikorde
88.   Hoe wordt een gecasteerde stier genoemd? 	Een os
89.   Welke vogels zijn zomers in grote aantallen op de dam te vinden? 	Duiven
90.   Hoe wordt het verblijf voor weggelopen of verstoten dieren genoemd? 	Asiel
91.   Hoe wordt het lichaam van een dood dier genoemd? 	Kadaver of kreng
92.   Hoe wordt een mannetjesvarken genoemd? 	Een beer
93.   Welk dier wordt in het engels woodpecker genoemd? 	De specht
94.   Welke vogel is het kleinste soort ter wereld? 	De kolibrie
95.   Wat is de verzamelnaam voor vogels die worden gehouden voor hun vlees eieren of dons? 	Pluimvee
96.   Hoeveel armen hebben de meeste zeesterren? 	5
97.   Wat is de andere benaming voor de arend? 	Adelaar
98.   Welke kleur heeft de zwarte neushoorn? 	Grijs
99.   Hoe wordt een bizon ook wel genoemd? 	Een buffel
100.  Wat wordt bedoeld met een toreo? 	Een stierengevecht