1.       Hoe wordt een babyschaap genoemd? 	Een lammetje
2.       Welke kleur heeft een goudvis meestal? 	Oranje
3.       Hoe wordt een jonge kat genoemd? 	Een kitten
4.       Welke siervogel heeft een grote staart bestaande uit ca. 50 veren? 	De pauw
5.       Op wat voor paard rijdt Sinterklaas? 	Een schimmel
6.       Door welke vogel zouden de baby’s worden gebracht? 	De ooievaar
7.       Welke zoogdieren danken hun naam een hun gebrul bij zonsopgang? 	De brulapen
8.       Welk dier staat symbool voor het Wereld Natuur Fonds 	De panda
9.       In welk werelddeel komt de koala in het wild voor? 	In Australië
10.   Hoe wordt iemand die bijen houdt genoemd? 	Imker
-------------------------------------------------------------------------
11.   Hoeveel harten heeft een worm? 	10
12.   Hoeveel bulten heeft een dromedaris? 	1
13.   Wat is een winterkoning voor dier? 	Een vogel
14.   Op welke dag worden de dieren extra verwend? 	Op dierendag
15.   Hoe wordt de broedplaats van vogels genoemd? 	Een (vogel)nest
16.   Wat eten panda’s meestal? 	Bamboe
17.   Hoeveel poten heeft een spin? 	8
18.   Hoe noem je het geluid dat een ezel maakt? 	Balken
19.   Welke dieren kun je in een volière houden? 	Vogels
20.   Welk leguaanachtig dier kan van kleur veranderen? 	Kameleon
21.   Wat is het best ontwikkelde zintuig van een hond? 	De neus
22.   Hoe wordt het jong van een kip genoemd? 	Kuiken
23.   Waarmee ademen vissen? 	Met hun kieuwen
24.   Met welke dieren wordt geschoten in het spel “Angry Birds”? 	Vogels
25.   Wat voor dier is Sebastiaan in de Disneyfilm “De kleine zeemeermin”? 	Een krab




26.   Wat voor dier is Hedwig in de films van Harry Potter? 	Een uil
27.   Hoe wordt een groep van dezelfde soort vissen genoemd? 	Een school
28.   Hoeveel levens heeft een kat spreekwoordelijk? 	9
29.   Welke roze vogels staan vaak op 1 poot in het water? 	Flamingo’s
30.   Wat is het hoogste dier ter wereld? 	De giraf
31.   Hoe wordt de larve van een vlinder genoemd? 	Rups
32.   In welk bergketen leeft de Alpensteenbok? 	De Alpen
33.   Wat voor dier is Winnie de Poeh 	Een beer
34.   Hoe wordt het jong van een varken genoemd? 	Een big
35.   Welk nog levend vogelsoort is het zwaarst? 	De struisvogel
36.   Hoe wordt het gelei genoemd waar eitjes van kikkers in worden gelegd? 	Kikkerdril
37.   Hoe wordt een mannetjesschaap genoemd? 	Een ram
38.   Hoe worden de uit de mond stekende lange tanden genoemd bij zoogdieren? 	Slagtanden
39.   Hoe wordt een vrouwtjeshond genoemd? 	Een teef
40.   Welk dier staat bekend om het spuwen naar zijn vijand? 	De lama
41.   In welke kleur kan de zwaan, behalve wit nog meer voorkomen? 	Zwart
42.   Welke 2 kleuren hebben orka’s? 	Zwart en wit
43.   Welk kevertje is rood met zwarte stippen? 	Het lieveheersbeestje
44.   Welke vogel jaagt ‘s nachts? 	De uil
45.   Hoe worden de melkklieren bij een koe genoemd? 	Uiers
46.   Welke kleur heeft een mestkever? 	Zwart
47.   Hoe worden de jonkies van honden genoemd? 	Puppies
48.   Hoe wordt een vrouwelijk paard genoemd? 	Een merrie
49.   Welk dier staat bekend om het maken van parels? 	De oester
50.   Welk dier verdedigd zichzelf met een stinkende vloeistof? 	Het stinkdier
51.   Welk dier wordt vaak ingezet als hulp bij blinden en slechtzienden? 	Een hond
52.   Welke vogel kun je leren praten? 	Een papegaai
53.   In de vorm van welke letter vliegen vogels meestal? 	De V
54.   Hoe wordt een mannelijke kip genoemd? 	Een haan
55.   Hoe worden de uitwerpselen van konijnen genoemd? 	(konijnen)keutels
56.   Welk hondenras is de kleinste ter wereld? 	De chihuahua
57.   Welk dier kan niet springen? 	Een olifant
58.   Hoe wordt een paard met een schofthoogte van minder dan 1.48 meter genoemd? 	Een pony
59.   Wat voor dier is Perry is in animatieserie Phineas en Ferb? 	Een vogelbekdier
60.   Van welk dier wordt gezegd dat het pootje geluk brengt? 	Het konijn
61.   Hoe wordt een mannetjes zebra genoemd? 	Een hengst
62.   Van welke kleur katten wordt gezegd dat ze ongeluk brengen? 	Zwarte
63.   Wat voor een dier is Bugs Bunny? 	Een konijn
64.   Welk soort aap dankt zijn naam aan zijn grote neus? 	De neusaap
65.   Hoeveel magen heeft een koe? 	4
66.   Wat doet een egel als hij bang is? 	Zich oprollen
67.   Welke kleur heeft het vlees van tonijn? 	Roze
68.   Welke dieren hebben en kwaakblaas? 	Kikkers
69.   Welke kleur heeft de vacht van een ijsbeer? 	Wit
70.   Hoeveel ogen hebben de meeste soorten spinnen? 	8
71.   Wat zijn dikkopjes? 	Kikkervisjes
72.   Welke vogels hakken met hun snavel hun nest in de boom 	Spechten
73.   Wat eet een dolfijn hoofdzakelijk? 	Vis
74.   Wat is de oudste dierentuin in Nederland? 	Artis
75.   Welke dieren worden in de VS gebruikt voor kinderrodeo? 	Schapen
76.   Wat voor dieren zijn dagpauwogen en koolwitjes? 	Vlinders
77.   Hoe heet het steekorgaan van wespen? 	Angel
78.   Waar bevinden zich de kieuwen bij een rog? 	Op zijn buik
79.   Wat voor dier is een dalmatiër? 	Een hond
80.   Welk dier kan vanwege zijn bouw niet omhoog kijken? 	Een varken
81.   Welk dier is het giftigste dier op aarde? 	Kikker
82.   Welke dieren zaten in een “groen groen knolle knolle land”? 	Haasjes
83.   Welke vissen hebben vinnen die op vleugels lijken? 	Vliegende vissen
84.   Wat is de grootste knaagdier die in Nederland voorkomt? 	De bever
85.   Hoe wordt de camouflagekleur van een dier genoemd? 	Schutkleur
86.   Welk dier kan van alle katachtigen het hardste brullen? 	De leeuw
87.   Welk zeedier gebruikt een soort sonar om zijn prooi op te sporen? 	Een dolfijn
88.   Hoe heet het geluid dat hanen maken? 	Kraaien
89.   Wat zijn de zwaarste en grootste mensapen? 	Gorilla’s
90.   Welk insect maakt een tjirpgeluid door zijn vleugels tegen elkaar te wrijven? 	Krekel
91.   Waarin begraaft een schilpad haar eieren? 	In het zand
92.   In welk werelddeel leen zebra’s in het wild? 	Afrika
93.   Wat voor een dier is een emoe? 	Een vogel
94.   Van welk dier mogen moslims het vlees niet eten? 	Varken
95.   Wat is in europa de meest voorkomende roofvogel? 	De buizerd
96.   Hoe wordt een mannelijk paard genoemd? 	Een hengst
97.   Welke kleur heeft geitenkaas? 	Wit
98.   Wat zijn de grootste roofdieren van het noordpoolgebied? 	IJsberen
99.   Wat voor dier is Patrick in de tekenfilmserie Spongebob Squarepants? 	Een zeester
100.  Hoe wordt een hond genoemd die niet tot een bepaald ras hoort? 	Een bastaard