1. Hoe wordt een geseponeerde rechtszaak genoemd? 	Sepot
2. Wat is het hardste materiaal van het menselijk lichaam? 	Tandglazuur
3. Hoe wordt een bijvoegsel of toevoegsel van een boek genoemd? 	Addendum
4. Welke bloedgroep komt het meest voor? 	O
5. Hoeveel amandelen hebben de meeste mensen? 	3
6. Van welke plant wordt de zalf calendula gemaakt? 	De goudsbloem
7. Hoe noem je het overblijfsel van een religieus voorwerp? 	Een relikwie
8. Wat bestudeert een osteoloog? 	Botten
9. Wat wordt bedoeld met horripilatie of spasmodermie? 	Kippenvel
10. Hoe heet de voorzitter van de Provinciale Staten? 	De commissaris van de koningin
11. Hoe wordt het genoemd als je links- en rechtshandig bent? 	Ambidextrie
12. In welk jaar werd de website Google gelanceerd? 	1998
13. Waarvan is Vodafone de afkorting? 	Voice Data Fone
14. Hoe wordt de vorm van graffiti genoemd waarbij de muren zo worden schoongemaakt dat er een patroon zichtbaar wordt? 	Reverse graffiti
15. Wat wordt bedoeld met proscopie? 	De toekomst voorspellen
16. Uit hoeveel kaarten bestaat een set tarotkaarten? 	78
17. Hoe wordt de studie naar China en alles wat met China te maken heeft genoemd? 	Sinologie
18. Waar ben je bang voor wanneer je last hebt van brontofobie? 	Onweer
19. Hoe wordt oogkunde ook wel genoemd? 	Optometrie
20. Waar werkt een kompel? 	In de mijnen
21. Waar houd een podoloog zich mee bezig? 	voeten
22. Bij welk spel kan men de Bermuda Bowl winnen? 	Bridge
23. Hoe noemen we een toevallige uitvinding? 	Serendipiteit
24. Welk bekend bordspel is bedacht door Klaus Teuber? 	De kolonisten van Catan
25. Wat is ontstoken wanneer je last hebt van gingivitis? 	Het tandvlees



	
26. Wie schreef de boeken van Mary Poppins? 	Pamela Lyndon Travers
27. Waarvoor staat de afkorting Aldi, het voordelige supermarktbedrijf? 	Albrecht Discount
28. Hoe wordt de troefnegen bij klaverjassen genoemd? 	De nel