1. Welke R&B-zangeres en actrice overleed in 2001 bij een vliegtuigongeluk? 	Aaliyah
2. welke naam is de Amerikaanse rapper Cornell Haynes beter bekend? 	Nelly
3. Wat was de naam van de eerste parfum die Jennifer Lopez uitbracht? 	Glow
4. Onder welke naam is rapper Armando Christian Pérez beter bekend? 	Pitbull
5. Hoe heet de dochter van Madonna? 	Lourdes
6. Hoe oud was zangeres Amy Winehouse toen zij overleed? 	27
7. Welke componist staat afgebeeld op de Oostenrijkse euromunt? 	Wolfgang Mozart
8. Tijdens welk nummer pinkte Maxima tijdens haar huwelijk een traantje weg? 	Adios Nonino
9. Welke componist heeft maar liefst 8 Oscars gewonnen voor de muziek voor Disneyfilms? 	Alan Menken
10. In welk concert van Leroy Anderson werd een schrijfmachine als instrumentgebruikt? 	The Typewriter
11. Van wie is Jo Calderone een alter-ego? 	Lady Gaga
12. In welke band zingt zanger Will.i.am? 	Black Eyed Peas
13. Van welke componist is de compositie Le Carnival des Animaux? 	Camille Saint-Saëns
14. Wat is de echte voornaam van zangeres Rihanna? 	Robyn
15. Welke sleutel wordt als enige gebruikt bij de klavarnotatie? 	De c-sleutel
16. Welke dans wordt in een groep gedanst bij Rueda de Casino? 	Salsa
17. Hoeveel minuten muziek konden er per kant op maximaal op een 12? LP 	30 minuten
18. Waarvan is MP3 de afkorting? 	MPEG-1 Layer 3
19. Van wie is Sasha Fierce het alter ego? 	Beyonce
20. Welke duo moest als enige ooit een Grammy Award weer inleveren? 	Milli Vanilli
21. Onder welke naam kennen we Alecia Beth Moore beter? 	P!nk
22. Welk nummer stond bij de eerste verschijning van de Nederlandse Top 40 op nummer één? 	I Feel Fine van de Beatles