1. Door welk bedrijf is de Playstation ontwikkeld? 	Sony
2. Hoe wordt de batterij genoemd in een horloge? 	Knoopcel
3. 2 audio kanalen noem je stereo. Hoe noem je 1 audio kanaal? 	Mono
4. Welk gereedschap gebruik je om je wiel te verwisselen? 	Krik
5. Welk soort verbinding is vernoemd naar Harald Blauwtand? 	Blluetooth
6. Hoe wordt draadloos internet in de volksmond genoemd? 	Wifi
7. Welke lamp is de opvolger voor de gloeilamp? 	De ledlamp
8. Hoe wordt een luidspreker met een engels woord vaak genoemd? 	Speaker
9. Wat is de afkorting van Playstation? 	PS
10. Wie is het meest bekende karakter van Nintendo? 	Mario Bros
11. Met welk gereedschap soldeer je? 	Soldeerbout
12. Hoeveel versnellingen hebben de meeste auto’s tegenwoordig? 	5
13. Hoe noem je de kracht die alles naar beneden trekt? 	Zwaartekracht
14. Hoe heet de opvolger van de smartphone Samsung Galaxy S2 	Samsung Galaxy S3
15. Welke kleur heeft een robijn? 	Rood
16. Hoeveel bit was de eerste Nintendo? 	8
17. Hoe noem je de controller met joystickknupper van de Wii? 	Nunchuck
18. hoe heet de Amerikaanse ruimtevaartorganisatie? 	NASA
19. Hoe noem je het kaartje in je telefoon dat gekoppeld is aan je telefoonnummer? 	Sim kaart
20. Hoeveel hoekpunten heeft een piramide? 	5
21. Met welk instrument kun je gemakkelijk een cirkel tekenen? 	Een passer
22. Met welk apparaat kun je 2 metalen delen aan elkaar vastmaken? 	Lasapparaat
23. Hoeveel autodeuren heeft een coupé? 	2
24. Hoe heet het onderdeel op de fiets dat stroom opwekt voor de verlichting? 	Dynamo
25. Welk huishoudelijk apparaat is gemaakt om wind te genereren? 	Ventilator




	
26. Welke molen wekt elektrische energie op? 	Windmolen
27. Hoe wordt het schudden van een vliegtuig ook wel genoemd? 	Turbulentie
28. Wat is het meest veilige vervoersmiddel? 	Vliegtuig
29. Hoe noem je het vloeibare gesteente dat uit de aarde vloeit? 	Magma
30. Welke kleur krijg je als rode en blauwe verf mengt? 	Paars
31. Welk figuur krijg je als je 2 driehoeken tegen elkaar aan legt? 	Vierkant
32. Hoe wordt een AA batterij ook wel genoemd? 	Een penlite
33. Hoeveel spanning komt er uit het stopcontact? 	220-230 volt
34. Hoeveel hoekpunten heeft een kubus? 	8
35. Hoeveel seconden zitten er in een uur? 	3600
36. Wat is de gewichtseenheid van diamanten? 	Karaat
37. Welke planeet uit ons zonnestelsel is als enige niet naar een mythologische god vernoemd? 	De Aarde
38. Met welk telefoonmerk kun je als enige officieel “pingen”? 	Blackberry
39. Een reservekopie van je bestanden maken noemen we? 	Een backup
40. Een geheim woord dat toegang geeft tot bepaalde informatie heet? 	Een wachtwoord / paswoord
41. Hoe wordt de gratis webmaildienst van Google genoemd? 	Gmail
42. Hoe heet het besturingssysteem voor mobiele apparaten van Google? 	Android
43. Bij welke temperatuur kookt water? 	100 graden celcius
44. Hoe wordt de tablet PC van Apple genoemd? 	Ipad
45. Wat is de meest bekende website voor het microbloggen? 	Twitter